00000000000000000
00001111110000000
00111111111109200
00110000011111100
00110000000111100
00110000000000000
00011111111110000
00001111111111000
01110000000011110
01111000000000110
01101100000000110
01101110000001110
03300111111001110
00000001111111110
00000000000000000
沙漠高地
:/game/resource/map1.png
1 3
1 10
1 12
2 15
2 20
1 25
2 27
3 30
3 32
1 35
1 37
1 40
2 45
3 48
3 50
1 52
1 55
1 57
2 58
2 60
