00000000000000000
00000000000000000
00000000333000000
00001111101100000
00111001100111000
01101111110001100
01000100111001100
01000110011001110
01000111011001110
01100011111001110
01111000111101110
00011111101101110
00001111101111110
00001100000111110
00000000000092990
午夜车站
:/game/resource/map2.png
1 3
1 10
1 12
2 15
2 20
1 25
2 27
3 30
3 32
1 35
1 37
1 40
2 45
3 48
3 50
1 52
1 55
1 57
2 58
2 60
3 61
3 62
3 63
2 65
1 70
1 72
1 73
3 75
2 78
2 80